черный = o-b-d-a-
черный полосатый = o-b-d-Tb-
черный абиссинский = o-b-d-Ta-
сероголубой = o-b-D-a-
сероголубой полосатый = o-b-D-Tb-
сероголубой абиссинский = o-b-D-Ta-
шоколадный = o-bl-d-a-
шоколадный полосатый = o-bl-d-Tb-
шоколадный абиссинский = o-bl-d-Ta-
lilac = o-bl-D-a-
lilac полосатый = o-bl-D-Tb-
lilac абиссинский = o-bl-D-Ta-
светлокоричневый = o-b0-d-a-
светлокоричневый полосатый = o-b0-d-Tb-
светлокоричневый абиссинский = o-b0-d-Ta-
fawn = o-b0-D-a-
fawn полосатый = o-b0-D-Tb-
fawn абиссинский = o-b0-D-Ta-
рыжий полосатый = r-b-d-Tb-
рыжий абиссинский = r-b-d-Ta-
кремовый полосатый = r-b-D-Tb-
кремовый абиссинский = r-b-D-Ta-
рыже-черный = or-b-d-a-
рыже-черный полосатый = or-b-d-Tb-
рыже-черный абиссинский = or-b-d-Ta-
кремово-сероголубой = or-b-D-a-
кремово-сероголубой полосатый = or-b-D-Tb-
кремово-сероголубой абиссинский = or-b-D-Ta-
рыже-шоколадный = or-bl-d-a-
рыже-шоколадный полосатый = or-bl-d-Tb-
рыже-шоколадный абиссинский = or-bl-d-Ta-
кремово-lilac = or-bl-D-a-
кремово-lilac полосатый = or-bl-D-Tb-
кремово-lilac абиссинский = or-bl-D-Ta-
рыже-светлокоричневый = or-b0-d-a-
рыже-светлокоричневый полосатый = or-b0-d-Tb-
рыже-светлокоричневый абиссинский = or-b0-d-Ta-
кремово-fawn = or-b0-D-a-
кремово-fawn полосатый = or-b0-D-Tb-
кремово-fawn абиссинский = or-b0-D-Ta-
белый=W